XXX22OXXX
X12222O2X
112122O22
1111X2OO2
222X2XOOO
22222OOO2
2O2OOOO22
XXO222OXX
XXXX2XXXX