XXXO2OXXX
XOOOOOOOX
1OOOOOOO1
OOOOXOOOO
OOOXOXOOO
OOOOOOOOO
2OOOOOOO2
XXOOOOOXX
XXXX1XXXX