XXX22OXXX
X12222OOX
112122OO1
1111X2OO1
222X2XOO2
22222OOO2
2O2OOOO22
XXO222OXX
XXXX2XXXX